3
100
6
5
######
#....#
#..+.#
#....#
######
