3
100
6
5
######
#A..C#
#..+.#
#B..D#
######
